11111111111111111111111111111111111111111111111111111111111111
10P000000000C000000000000000010000000C000000000001000000000001
111000000C000000000000000000010000C00000010000000100C111111111
1000000000000C000000000000001100000000C00000000001000000011111
1000000000000000C000000000001101000000000C00000001000000000001
1111100000000000C000000000001100000000000C000000010000011111C1
100C111111000000C000000000001100000000000C00000000000000000111
10000C00000000000C000000000001000000000000C00000000000000000C1
10000000000000000C000000000001000000000000C0000001000000011111
1000000000000000C000000000000100000000000C00000001000000011111
10000000000000C000000000000001000000000C0000000001000000011111
1111111000000C000000000000000100000000C00000000001000000011111
100000000000C000000000000000010000000C000000000001000000011111
1CCCCCC00000C000000000000000010000000C000000000001000000011111
10000000000C000000000000000001000000C0000000000001000000000001
111000000000C000000000000000000000000C00010000000100C111111111
100000000000C000000000000000000000000C000000000001000000011111
100000000000C000000010000000000000000C000000000001000000000001
111110000000000C000010000000000000000000C0000000010000011111C1
100C1111110000000C001000000000000000000000C0000000000000000111
10000C00000000000C001000000000000000000000C00000000000000000C1
1000000000000C000000100000000000000000C00000000001000000011111
1000000000000C000000100000000000000000C00000000001000000011111
10000000000000C000001000000000000000000C0000000001000000011111
111111100000000C000010000000000000000000C000000001000000011111
100000000000000C000010000000000000000000C000000001000000011111
1CCCCCC00000000C000010000000000000000000C0000000010000000000E1
11111111111111111111111111111111111111111111111111111111111111