111111111111111111111111111111111111111
1P000010000C0000000100000C0000001000001
100000000000C00000000000C00000000000001
10000010000C0000000100000C0000001000001
100000000000000000000000000000000000001
10000010000C0000000100000C0000001000001
100000000000C00000000000C00000000000001
10000010000C0000000100000C0000001000001
100000000000000000000000000000000000001
10000010000C0000000100000C0000001000001
100000000000C00000000000C00000000000001
10000010000C0000000100000C0000001000001
100000000000000000000000000000000000001
10000010000C0000000100000C0000001000001
100000000000C00000000000C00000000000001
10000010000C0000000100000C0000001000001
100000000000000000000000000000000000001
10000010000C0000000100000C0000001000001
100000000000C00000000000C00000000000001
10000010000C0000000100000C00000010000E1
111111111111111111111111111111111111111