11111111111111111111111111111111111111111111111111111111111111
100000000000C000000000000000010000000C000000000001000000000001
1P0000000000C000000000000000010000000C000000000001000000000001
100000000000C000000000000000010000000C000000000001000000000001
100000000000C000000000000000000000000C000000000000000000000001
100000000000C000000000000000010000000C000000000001000000000001
100000000000C000000000000000010000000C000000000001000000000001
100000000000C000000000000000010000000C000000000001000000000001
100000000000C000000000000000010000000C000000000001000000000001
100000000000C000000000000000010000000C000000000001000000000001
100000000000C000000000000000000000000C000000000001000000000001
100000000000C000000000000000010000000C000000000001000000000001
100000000000C000000000000000010000000C000000000001000000000001
100000000000C000000000000000010000000C000000000001000000000001
100000000000C000000000000000010000000C000000000001000000000001
100000000000C000000000000000000000000C000000000000000000000001
100000000000C000000000000000010000000C000000000001000000000001
100000000000C000000000000000010000000C000000000001000000000001
100000000000C000000000000000010000000C000000000001000000000001
100000000000C000000000000000010000000C000000000001000000000001
100000000000C000000000000000010000000C000000000001000000000001
100000000000C000000000000000010000000C000000000001000000000001
100000000000C000000000000000010000000C000000000001000000000001
100000000000C000000000000000010000000C000000000001000000000001
100000000000C000000000000000010000000C000000000001000000000001
111000000000C000000000000000010000000C000000000001000000000001
1C1000000000C000000000000000000000000CE00000000001000000000001
11111111111111111111111111111111111111111111111111111111111111