11111111111111111111111111111111
10000000000000010000000000000001
1C111110000C0001000C0000011111C1
10000000000000010000000000000001
10000000000000010000000000000001
1C1111100000000100000000011111C1
10000000000000000000000000000001
10000000000C0000000C000000000001
1C1111100000000100000000011111C1
10000000000000010000000000000001
10000000000000010000000000000001
1C111110000C0001000C0000011111C1
10000000000000010000000000000001
1P0000000000000100000000000000E1
11111111111111111111111111111111