11111111111111111111111111111111
1EP00000000000000001000000000001
1110000000010000000100C111111111
10000000000000000001000000011111
10000000000000000001000000000001
111110000000000000010000011111C1
100C1111110000000000000000000111
10000C000000000000000000000000C1
10000000000000000001000000011111
10000000000000000001000000011111
10000000000000000001000000011111
11111110000000000001000000011111
10000000000000000001000000011111
1CCCCCC0000000000001000000011111
11111111111111111111111111111111