11111111111
10000000001
10P0001E0C1
10000011111
10000000001
111110000C1
10001000001
1CCCCCCCCC1
11111111111