11111111111
1P0C0C0C0C1
10000011E01
10000011111
10000000001
11111000001
10011000001
1C0C0C0C0C1
11111111111