1111111111111111
1P00000000000001
100000000001E0C1
100P000000011111
1000000000000001
11111000011100C1
1000100000000001
1C000C00000000C1
1111111111111111