1111111111111111
1100000000000001
1C000001C1C1E1C1
1100000111111111
1000000000000001
1111111110000011
1C1C1C1C100000P1
1000000000000011
1111111111111111